,p_id,ycount,gcount,hfcount,fcount,sum,difference,percentage
0,1,1,0,0,19,20,-11.901369863013699,-0.37306767433871524
1,2,0,0,0,1,1,0.4904109589041096,0.9623655913978494
2,3,1,6,0,435,442,-4.734246575342468,-0.010597456119908257
3,4,524,0,0,1849,2373,658.8904109589041,0.3843922320786382
4,5,0,0,0,63,63,9.602739726027394,0.17983581323755765
5,6,0,0,0,110,110,20.043835616438358,0.22281781080587199
6,7,373,516,0,4930,5819,2439.2246575342465,0.721712069700669
7,8,0,0,0,21,21,1.843835616438355,0.09625286041189925
8,9,1,0,0,217,218,6.816438356164383,0.032277315067071426
9,10,23,11,0,714,748,-16.641095890410952,-0.021763276888790147
10,11,1,3,0,255,259,-14.399999999999977,-0.052670080468178414
11,12,36,0,0,27,63,-6.802739726027397,-0.09745662924876364
12,13,689,0,0,1117,1806,-402.11506849315083,-0.18210784131261776
13,14,10,14,0,1404,1428,139.21917808219177,0.10802393682039944
14,15,3,2,0,165,170,-7.701369863013696,-0.04333883227208953
15,16,0,6,0,777,783,267.2630136986302,0.518215720022949
16,17,44,78,0,3690,3812,1501.7424657534248,0.6500324935605828
17,18,5,12,0,1244,1261,254.58082191780818,0.2529570455949888
18,19,3,1,0,205,209,30.309589041095904,0.16962068013860362
19,20,1,4,0,685,690,103.39999999999998,0.1762700306853051
20,21,5,13,0,758,776,113.4849315068493,0.17129411375497272
21,22,3,11,0,748,762,1.8136986301369689,0.0023858607118658498
22,23,1,0,0,287,288,61.643835616438366,0.2723311546840959
23,24,427,25,0,521,973,85.91506849315067,0.0968510065290037
24,25,146,127,0,1948,2221,593.7890410958903,0.36491214482465995
25,26,12,14,0,886,912,-116.72602739726017,-0.11346658321903662
26,27,0,0,0,12,12,2.758904109589041,0.29854728728135194
27,28,10,10,0,514,534,14.189041095890389,0.027296540892105096
28,29,4,4,0,458,466,38.82739726027398,0.09089393142549292
29,30,0,0,0,14,14,6.005479452054795,0.7511994516792324
30,31,1,0,0,151,152,36.33698630136986,0.3141625411564062
31,32,2,15,0,582,599,57.75068493150684,0.10669886007005606
32,33,128,134,0,1529,1791,292.2328767123288,0.19498217713188923
33,34,2,0,0,116,118,-37.37534246575342,-0.24054873748060374
34,35,13,41,0,1384,1438,-3.6438356164383094,-0.002527556062333681
35,36,51,115,0,4765,4931,2524.895890410959,1.049371006162409
36,37,55,56,0,5465,5576,2544.769863013699,0.8395172085296535
37,38,1,2,0,225,228,12.68219178082191,0.0588998740313776
38,39,9,51,0,1963,2023,-57.706849315068666,-0.02773425258539651
39,40,63,32,0,884,979,199.12876712328762,0.25533544350489884
40,41,585,454,0,2226,3265,614.5534246575344,0.23186787855858879
41,42,243,320,0,3041,3604,694.5863013698631,0.23873755103885738
42,43,1383,55,0,861,2299,70.80000000000018,0.03177452652365146
43,44,0,0,0,86,86,28.21917808219178,0.48838311996206735
44,45,317,0,0,952,1269,423.9917808219178,0.5017605405475508
45,46,0,0,0,43,43,10.553424657534244,0.32525542514565553
46,47,10,15,0,736,761,17.301369863013747,0.023263952845828027
47,48,4356,0,0,5820,10176,2236.2520547945205,0.28165277666590294
48,49,55,94,0,2551,2700,755.8712328767124,0.38879689743759577
49,50,1319,0,0,2207,3526,711.504109589041,0.2527998395780747
50,51,12,31,0,840,883,169.14794520547946,0.23695098174672624
51,52,87,55,0,430,572,79.60000000000002,0.16165718927701062
52,53,0,4,0,406,410,73.0219178082192,0.2166963421872079
53,54,8,6,0,223,237,33.31780821917809,0.16357742386742713
54,55,2,26,0,520,548,-8.51780821917805,-0.015305544752349435
55,56,8,18,0,952,978,118.05479452054794,0.1372817637313623
56,57,0,1,0,47,48,3.7178082191780817,0.08395718616593453
57,58,0,0,0,66,66,3.865753424657534,0.06221614709643281
58,59,0,1,0,39,40,0.7315068493150676,0.018628340193957975
59,60,0,4,0,562,566,70.92602739726027,0.1432634945933083
60,61,43,124,0,5434,5601,1576.1068493150683,0.3915897367478826
61,62,11,22,0,1211,1244,209.34520547945203,0.20233338364460118
62,63,3,4,0,906,913,123.08493150684933,0.15582046275132755
63,64,0,1,0,152,153,6.832876712328755,0.04674701505126418
64,65,155,113,0,1509,1777,343.1287671232876,0.23930235801919506
65,66,72,87,0,982,1141,111.11232876712324,0.10788781327395722
66,67,2,1,0,437,440,29.950684931506828,0.07304166555309079
67,68,3338,1,0,4037,7376,1832.3835616438355,0.3305393838155202
68,69,18,27,0,1672,1717,381.76986301369857,0.2859206457662626
69,70,19,11,0,733,763,110.26301369863017,0.16892410881053022
70,71,9,31,0,1175,1215,78.78630136986294,0.06934109443043218
71,72,18,28,0,1551,1597,78.33698630136996,0.05158286308071995
72,73,1,1,0,288,290,8.928767123287685,0.0317669191254594
73,74,560,435,0,2084,3079,150.37534246575342,0.051346744649880066
74,75,889,280,0,1909,3078,48.15342465753429,0.015893024105384436
75,76,24,78,0,2365,2467,78.76712328767144,0.032981341164728985
76,77,7,19,0,696,722,-4.342465753424676,-0.0059785376157516805
77,78,5,11,0,855,871,-11.339726027397205,-0.012851881982524608
78,79,6609,1,0,8927,15537,7576.739726027397,0.95182060199725
79,80,161,240,0,6155,6556,4035.4575342465755,1.6010273935378123
80,81,4,16,0,672,692,43.076712328767144,0.0663818253207632
81,82,88,412,0,2282,2782,915.2054794520548,0.49025507059203377
82,83,22,61,0,757,840,260.8630136986301,0.4504340421505782
83,84,0,0,0,139,139,46.74246575342465,0.5066520163924689
84,85,10,15,0,1033,1058,297.0931506849315,0.3904461511318506
85,86,3,4,0,280,287,19.515068493150693,0.07295763684038023
86,87,768,1,0,2278,3047,712.364383561644,0.3051287226776759
87,88,343,2,0,529,874,102.5369863013699,0.13291238138530603
88,89,35,41,0,2675,2751,696.895890410959,0.33926999471822544
89,90,2394,0,0,2828,5222,1278.4465753424656,0.3241864475193431
90,91,15,31,0,1429,1475,120.17534246575337,0.08870176800920501
91,92,7,56,0,1467,1530,268.2602739726028,0.21261141932752134
92,93,18,2,0,116,136,-2.1205479452054874,-0.015352878168762702
93,94,2,7,0,529,538,130.26575342465753,0.319486907265678
94,95,33,183,0,1578,1794,298.10684931506853,0.19928351779575498
95,96,0,0,0,48,48,-4.961643835616435,-0.09368372044901965
96,97,119,175,0,1926,2220,426.38082191780813,0.23772093158242838
97,98,4,2,0,230,236,-1.0684931506849296,-0.004507107361608683
98,99,1,0,0,17,18,8.841095890410958,0.9653006281782829
99,100,1836,0,0,1977,3813,-494.7013698630135,-0.11484114783907251
100,101,3,0,0,134,137,-39.457534246575335,-0.22360923502103805
101,102,3,3,0,566,572,36.04657534246576,0.0672569176426085
102,103,0,0,0,0,0,0.0,
103,104,0,0,0,0,0,0.0,
104,105,0,0,0,0,0,-0.1589041095890411,-1.0
105,106,24,15,0,781,820,277.9835616438356,0.5128692452334257
106,107,3074,0,0,3720,6794,1420.9753424657538,0.264464697825872
107,108,3,15,0,381,399,39.013698630137014,0.1083755089615283
108,109,0,0,0,187,187,73.88493150684931,0.6531838108847821
109,110,0,0,0,1,1,0.3178082191780822,0.4658634538152611
110,111,1,0,0,28,29,8.317808219178083,0.40217247317525506
111,112,97,159,0,3403,3659,1384.054794520548,0.6083903872440102
112,113,1583,0,0,2120,3703,469.24383561643845,0.14510798333673638
113,114,2464,0,0,3199,5663,2502.2575342465752,0.7916676418146941
114,115,0,2,0,129,131,-35.61369863013698,-0.2137501233268655
115,116,170,171,0,1670,2011,388.58356164383554,0.23950913739357152
116,117,1,1,0,237,239,0.7287671232876676,0.003058561096482639
117,118,0,0,0,185,185,43.19999999999999,0.3046544428772919
118,119,6,22,0,1171,1199,294.17808219178085,0.32512263065463576
119,120,2,1,0,145,148,31.372602739726034,0.26899856703234754
120,121,7,3,0,535,545,38.56712328767122,0.07615446204449058
121,122,2,1,0,256,259,1.1095890410958873,0.004302560288962061
122,123,3,7,0,810,820,148.3917808219178,0.22094991780106632
123,124,5,3,0,270,278,1.5315068493150648,0.005539534837629184
124,125,771,0,0,1048,1819,326.6082191780822,0.21884884611077557
125,126,1,5,0,539,545,-0.3452054794520336,-0.0006330036020918873
126,127,12,36,0,1469,1517,554.3808219178082,0.5759087648994183
127,128,0,0,0,64,64,5.7506849315068465,0.09872536569305296
128,129,136,356,0,2561,3053,691.7808219178082,0.2929761151947276
129,130,18,101,0,1363,1482,199.1972602739727,0.1552828459943233
130,131,3,7,0,395,405,52.16438356164383,0.147843304732694
131,132,1821,0,0,3187,5008,-725.2876712328771,-0.12650467111079258
132,133,10,8,0,572,590,53.45479452054792,0.09962775545218261
133,134,4,34,0,472,510,-30.660273972602795,-0.0567089454294851
134,135,5,9,0,419,433,-45.38082191780819,-0.09486338046721526
135,136,7,10,0,858,875,240.85205479452054,0.37980420281339644
136,137,1514,0,0,2665,4179,608.2191780821918,0.17033226300222123
137,138,1789,0,0,2202,3991,-1133.1589041095895,-0.22114046916085933
138,139,2,6,0,338,346,-1.2630136986301181,-0.003637052173158343
139,140,1584,0,0,1713,3297,-667.1945205479451,-0.168305192161893
140,141,2776,0,0,2296,5072,180.94246575342459,0.03699454861990234
141,142,2929,0,0,2295,5224,629.9342465753425,0.13711911852932374
142,143,1290,0,0,1623,2913,-199.08493150684944,-0.0639715611522382
143,144,1640,1,0,2835,4476,1754.7315068493149,0.6448211601559707
144,145,108,87,0,2456,2651,862.695890410959,0.482410058661225
145,146,164,63,0,1075,1302,475.38630136986296,0.5751009233910258
146,147,4,8,0,669,681,139.26575342465753,0.2570739330309053
147,148,4993,0,0,7612,12605,7190.3452054794525,1.3279415730723674
148,149,3,5,0,505,513,-23.986301369862986,-0.04466836734693873
149,150,1,7,0,343,351,22.38082191780819,0.06810564754139353
150,151,1101,0,0,1112,2213,77.50410958904104,0.036293260940963926
151,152,126,69,0,845,1040,190.5369863013699,0.22430286337218683
152,153,1,1,0,168,170,25.632876712328766,0.17755342164193266
153,154,0,0,0,24,24,0.37260273972602675,0.015769944341372886
154,155,4,13,0,615,632,-41.56438356164381,-0.06170810775632391
155,156,1,0,0,267,268,45.76164383561644,0.20591244745244525
156,157,9,7,0,1366,1382,713.3506849315069,1.066853235104914
157,158,1951,0,0,2744,4695,1730.2493150684932,0.5836070209419536
158,159,7,17,0,962,986,55.60273972602738,0.059762363992402694
159,160,6,4,0,558,568,58.342465753424676,0.11447386104018281
160,161,2350,0,0,2332,4682,-1015.5726027397259,-0.17824653998290066
161,162,2280,0,0,2077,4357,-823.8164383561643,-0.15901285987610775
162,163,2523,0,0,2311,4834,704.9397260273972,0.17072643150088215
163,164,2562,0,0,3847,6409,1167.1671232876715,0.22266393277683386
164,165,6,14,0,845,865,101.6739726027397,0.13319861887773043
165,166,554,213,0,1387,2154,148.4356164383562,0.07401189293896025
166,167,5,15,0,1060,1080,155.3397260273972,0.16799653926951322
167,168,37,25,0,1414,1476,282.81369863013697,0.23702392351089402
168,169,5,17,0,1466,1488,363.8465753424657,0.32366273798730727
169,170,2805,0,0,3032,5837,-299.0328767123292,-0.04873391044680162
170,171,3,5,0,546,554,73.52876712328765,0.1530346919690714
171,172,0,0,0,87,87,2.5424657534246506,0.030103480714957585
172,173,17,26,0,878,921,258.30684931506846,0.3897834903651765
173,174,3,6,0,883,892,47.175342465753374,0.055840394861866385
174,175,1,2,0,177,180,-31.191780821917803,-0.14769410391126675
175,176,0,0,0,52,52,-5.19178082191781,-0.09077844311377248
176,177,13,24,0,1377,1414,238.78630136986294,0.20318543057164765
177,178,2,1,0,330,333,34.1698630136986,0.11434543837613331
178,179,105,69,0,1385,1559,462.00273972602736,0.42115213634229426
179,180,1,5,0,391,397,69.27397260273972,0.2113776960374519
180,181,136,164,0,3519,3819,1112.0931506849315,0.4108353972233384
181,182,10,27,0,634,671,74.91780821917803,0.12568368800845695
182,183,1,4,0,241,246,13.778082191780811,0.0593315321905121
183,184,1,0,0,70,71,24.526027397260272,0.5277368390025349
184,185,4,7,0,603,614,5.783561643835583,0.009509051842575812
185,186,2889,0,0,2041,4930,-857.224657534247,-0.1481236185324596
186,187,0,0,0,145,145,18.983561643835614,0.15064353422036697
187,188,47,57,0,2461,2565,593.2904109589042,0.300901519299016
188,189,33,22,0,1442,1497,532.3534246575342,0.551863696264655
189,190,8,7,0,328,343,159.91232876712328,0.8734194262797971
190,191,5,10,0,556,571,-5.339726027397205,-0.009264893232682304
191,192,2,1,0,309,312,-23.736986301369882,-0.07070113591852728
192,193,47,14,0,371,432,32.28767123287673,0.08077727132526823
193,194,12,0,0,46,58,34.460273972602735,1.463919925512104
194,195,29,110,0,552,691,261.0,0.6069767441860465
195,196,18,44,0,710,772,215.47397260273976,0.3871768111375855
196,197,10,7,0,1305,1322,387.4328767123287,0.4145586411700384
197,198,9,5,0,2727,2741,1146.6520547945206,0.7191981262576533
198,199,0,0,0,0,0,-0.23835616438356164,-1.0
199,200,2,14,0,423,439,43.35068493150686,0.10956845691493786
200,201,0,0,0,108,108,16.989041095890414,0.18667027905716613
201,202,5,1,0,182,188,34.684931506849324,0.2262330235882774
202,203,5,4,0,365,374,0.9698630136986139,0.0025999588707070866
203,204,0,0,0,58,58,15.989041095890414,0.38059214816747106
204,205,10,17,0,776,803,-17.649315068493138,-0.02150652507035857
205,206,0,0,0,514,514,108.65479452054797,0.2680549641435341
206,207,1,0,0,2,3,-1.235616438356164,-0.2917205692108667
207,208,7,10,0,790,807,157.76164383561638,0.24299495299022658
208,209,297,0,0,778,1075,365.82191780821915,0.5158392891636082
209,210,7,28,0,681,716,-43.12054794520543,-0.056803294367310346
210,211,838,0,0,1675,2513,637.2794520547945,0.33975181044581226
211,212,4,19,0,646,669,136.88219178082193,0.257240388625446
212,213,8,34,0,1008,1050,19.539726027397364,0.018962134223834113
213,214,0,0,0,148,148,23.336986301369862,0.1872005626126324
214,215,16,19,0,626,661,-29.575342465753465,-0.04282710465762126
215,216,17,10,0,1330,1357,102.3260273972603,0.0815558699962442
216,217,18,8,0,483,509,147.17808219178085,0.4067693938590846
217,218,4,18,0,440,462,12.339726027397262,0.027442330892119473
218,219,10,5,0,394,409,-16.610958904109566,-0.03902850374642732
219,220,1,18,0,1000,1019,271.18356164383556,0.3626338600418386
220,221,1,0,0,285,286,12.53972602739725,0.045855750252973025
221,222,11,28,0,271,310,-23.567123287671222,-0.07065181680793742
222,223,87,138,0,1890,2115,470.92328767123286,0.28643632267267466
223,224,335,0,0,1065,1400,68.35068493150675,0.05132784146552213
224,225,29,61,0,3208,3298,845.4109589041095,0.3447014337658275
225,226,228,67,0,1611,1906,140.05205479452047,0.07930701195058414
226,227,2,5,0,624,631,89.30136986301375,0.16485433946995762
227,228,7,9,0,1102,1118,181.06849315068496,0.1932569156091
228,229,1970,0,0,2122,4092,-99.4739726027401,-0.02373245623209028
229,230,3876,0,0,3640,7516,1633.7643835616436,0.2777454848962467
230,231,1818,0,0,3560,5378,843.1260273972603,0.18592049800964094
231,232,449,0,0,1823,2272,597.2328767123288,0.35660652063668635
232,233,1271,0,0,2190,3461,160.88767123287653,0.048752180291081776
233,234,2736,1,0,3641,6378,814.6931506849314,0.1464404485949275
234,235,12,18,0,1277,1307,168.90136986301377,0.14840661906664812
235,236,3389,12,0,1745,5146,-1149.3534246575346,-0.1825717075956
236,237,3279,0,0,2020,5299,-844.9835616438359,-0.13753024453368795
237,238,2361,0,0,2136,4497,171.61917808219187,0.03967724118360948
238,239,3011,0,0,2197,5208,559.6684931506852,0.1204020178694256
239,240,0,2,0,243,245,48.36986301369862,0.24599414797269048
240,241,4,12,0,1015,1031,147.5424657534246,0.16700572470554664
241,242,3,4,0,745,752,-51.64657534246578,-0.06426528392839492
242,243,29,65,0,2093,2187,572.0164383561644,0.3541933502864442
243,244,115,136,0,2459,2710,432.98904109589057,0.19015676644098436
244,245,0,0,0,320,320,142.27671232876713,0.8005518814842222
245,246,1891,0,0,3048,4939,962.5671232876712,0.24206799237700477
246,247,22,35,0,1429,1486,449.79999999999995,0.4340860837676124
247,248,2,16,0,559,577,31.200000000000045,0.057163796262367256
248,249,3524,1,0,4167,7692,2818.635616438356,0.5783757163625814
249,250,2,11,0,539,552,53.643835616438366,0.10764156129741619
250,251,0,0,0,163,163,38.83287671232877,0.31274685024602283
251,252,3,1,0,292,296,6.767123287671211,0.023396798332859636
252,253,0,0,0,19,19,2.4904109589041106,0.15084633255891144
253,254,6,14,0,1121,1141,131.4849315068493,0.13024563536541348
254,255,324,506,0,6176,7006,3862.780821917808,1.2289250615589113
255,256,263,232,0,4407,4902,2490.0027397260274,1.0323406169388412
256,257,6,11,0,434,451,41.30684931506852,0.10082387085556856
257,258,2,5,0,835,842,112.00547945205483,0.15343331531856128
258,259,4,13,0,883,900,214.76438356164385,0.31341684292174277
259,260,109,221,0,1453,1783,534.7287671232878,0.42837546283188377
260,261,580,0,0,1261,1841,541.0219178082191,0.416177722701331
261,262,1452,0,0,1441,2893,-427.72054794520545,-0.1288035357898063
262,263,2623,1,0,2426,5050,908.3561643835619,0.2193226169213469
