p_id,ycount,gcount,hfcount,fcount,sum
1,1,0,0,42,43
2,0,0,0,0,0
3,1,13,0,368,382
4,229,0,0,1140,1369
5,0,0,0,45,45
6,0,0,0,55,55
7,224,407,0,1880,2511
8,1,0,0,15,16
9,2,2,0,165,169
10,22,11,0,555,588
11,6,6,0,243,255
12,53,0,0,28,81
13,1172,0,0,1167,2339
14,4,21,0,1013,1038
15,0,3,0,157,160
16,1,4,0,341,346
17,19,69,0,1632,1720
18,1,20,0,702,723
19,2,3,0,158,163
20,0,17,0,436,453
21,3,11,0,567,581
22,4,15,0,622,641
23,0,0,0,163,163
24,360,47,0,383,790
25,108,169,0,950,1227
26,6,19,0,1158,1183
27,0,0,0,1,1
28,8,8,0,437,453
29,0,9,0,366,375
30,0,0,0,4,4
31,1,4,0,75,80
32,2,18,0,369,389
33,131,305,0,922,1358
34,5,0,0,94,99
35,1,24,0,1134,1159
36,6,19,0,1507,1532
37,17,18,0,1919,1954
38,0,0,0,187,187
39,8,30,0,1696,1734
40,89,85,0,471,645
41,407,582,0,1226,2215
42,221,414,0,1712,2347
43,1663,135,0,703,2501
44,0,0,0,31,31
45,140,0,0,440,580
46,0,0,0,21,21
47,0,15,0,560,575
48,3812,1,0,3094,6907
49,32,124,0,1319,1475
50,1211,0,0,1254,2465
51,1,10,0,522,533
52,119,121,0,278,518
53,1,0,0,274,275
54,9,6,0,159,174
55,0,35,0,408,443
56,5,24,0,638,667
57,0,3,0,38,41
58,0,0,0,39,39
59,0,1,0,36,37
60,0,4,0,359,363
61,14,113,0,3018,3145
62,5,26,0,984,1015
63,1,4,0,655,660
64,0,1,0,124,125
65,174,108,0,816,1098
66,55,208,0,664,927
67,2,4,0,344,350
68,2579,0,0,2291,4870
69,3,26,0,1002,1031
70,13,10,0,500,523
71,5,26,0,898,929
72,5,25,0,1135,1165
73,0,3,0,234,237
74,476,796,0,1360,2632
75,853,685,0,1309,2847
76,8,40,0,1897,1945
77,0,19,0,580,599
78,2,15,0,661,678
79,2200,0,0,3097,5297
80,21,33,0,1247,1301
81,1,8,0,496,505
82,47,311,0,1137,1495
83,11,46,0,376,433
84,0,0,0,54,54
85,1,21,0,609,631
86,0,0,0,226,226
87,727,1,0,1134,1862
88,314,0,0,241,555
89,11,41,0,1568,1620
90,1822,0,0,1634,3456
91,2,35,0,1071,1108
92,4,56,0,881,941
93,12,2,0,70,84
94,0,9,0,287,296
95,21,263,0,1166,1450
96,0,0,0,45,45
97,77,194,0,1181,1452
98,1,2,0,189,192
99,0,0,0,4,4
100,2930,0,0,1201,4131
101,0,0,0,153,153
102,1,8,0,410,419
103,0,0,0,0,0
104,0,0,0,0,0
105,0,0,0,0,0
106,10,18,0,321,349
107,2581,0,0,2200,4781
108,0,14,0,287,301
109,0,0,0,70,70
110,0,0,0,0,0
111,0,1,0,17,18
112,14,53,0,1571,1638
113,1709,1,0,1506,3216
114,896,0,0,1133,2029
115,0,0,0,112,112
116,156,185,0,923,1264
117,1,1,0,149,151
118,0,0,0,86,86
119,11,18,0,615,644
120,0,2,0,77,79
121,1,19,0,449,469
122,0,3,0,220,223
123,2,22,0,709,733
124,0,5,0,220,225
125,710,0,0,788,1498
126,0,13,0,411,424
127,8,51,0,584,643
128,2,1,0,38,41
129,71,261,0,1591,1923
130,10,108,0,877,995
131,0,5,0,292,297
132,2897,2,0,4504,7403
133,5,10,0,468,483
134,8,71,0,409,488
135,5,10,0,409,424
136,2,19,0,450,471
137,1532,0,0,1815,3347
138,4283,1,0,3638,7922
139,0,5,0,297,302
140,2457,0,0,1862,4319
141,3105,0,0,2070,5175
142,2801,0,0,1734,4535
143,1530,0,0,1850,3380
144,651,0,0,1392,2043
145,55,180,0,1085,1320
146,107,27,0,424,558
147,0,5,0,380,385
148,930,0,0,2054,2984
149,0,14,0,482,496
150,0,8,0,250,258
151,1163,0,0,1012,2175
152,104,96,0,466,666
153,0,1,0,92,93
154,0,0,0,15,15
155,0,21,0,600,621
156,0,0,0,184,184
157,4,6,0,516,526
158,1021,0,0,1399,2420
159,9,42,0,657,708
160,1,4,0,409,414
161,3335,1,0,1645,4981
162,3555,0,0,1290,4845
163,2465,0,0,1300,3765
164,2200,0,0,1736,3936
165,3,22,0,748,773
166,573,374,0,972,1919
167,5,9,0,694,708
168,9,41,0,762,812
169,1,18,0,790,809
170,3866,0,0,2206,6072
171,1,2,0,394,397
172,0,0,0,55,55
173,5,22,0,471,498
174,2,21,0,638,661
175,1,3,0,174,178
176,0,0,0,36,36
177,4,17,0,925,946
178,1,8,0,335,344
179,98,70,0,646,814
180,1,4,0,226,231
181,72,188,0,1862,2122
182,2,34,0,423,459
183,0,3,0,165,168
184,0,2,0,23,25
185,3,21,0,487,511
186,4831,1,0,1311,6143
187,0,0,0,104,104
188,12,41,0,1592,1645
189,19,30,0,629,678
190,3,4,0,109,116
191,1,5,0,420,426
192,2,4,0,273,279
193,59,29,0,204,292
194,5,0,0,6,11
195,2,6,0,260,268
196,29,66,0,428,523
197,9,16,0,720,745
198,7,8,0,1222,1237
199,0,0,0,0,0
200,0,6,0,331,337
201,0,0,0,44,44
202,3,1,0,125,129
203,1,1,0,303,305
204,0,0,0,26,26
205,2,14,0,631,647
206,0,0,0,357,357
207,0,0,0,1,1
208,2,4,0,496,502
209,159,0,0,373,532
210,1,34,0,693,728
211,575,0,0,1040,1615
212,1,11,0,400,412
213,3,32,0,837,872
214,0,0,0,91,91
215,12,12,0,514,538
216,8,19,0,1013,1040
217,10,9,0,321,340
218,0,6,0,320,326
219,5,1,0,336,342
220,4,16,0,557,577
221,0,0,0,210,210
222,3,6,0,287,296
223,79,152,0,984,1215
224,363,0,0,1069,1432
225,4,32,0,1818,1854
226,249,81,0,1085,1415
227,2,9,0,427,438
228,9,17,0,666,692
229,2307,0,0,1662,3969
230,2781,0,0,1810,4591
231,1779,0,0,2487,4266
232,115,0,0,1263,1378
233,1447,0,0,1505,2952
234,2620,0,0,2146,4766
235,7,14,0,826,847
236,5116,41,0,2113,7270
237,4905,1,0,1915,6821
238,2522,0,0,1991,4513
239,2737,0,0,1958,4695
240,0,2,0,136,138
241,1,19,0,638,658
242,2,31,0,617,650
243,17,83,0,1107,1207
244,147,262,0,1453,1862
245,0,0,0,114,114
246,1370,0,0,2272,3642
247,14,44,0,671,729
248,0,7,0,432,439
249,1770,1,0,1972,3743
250,2,10,0,380,392
251,0,0,0,95,95
252,1,1,0,243,245
253,0,0,0,8,8
254,4,9,0,785,798
255,38,89,0,1572,1699
256,52,43,0,1392,1487
257,2,7,0,382,391
258,2,5,0,570,577
259,2,4,0,546,552
260,98,203,0,813,1114
261,447,0,0,550,997
262,1820,0,0,1774,3594
263,2123,17,0,1664,3804
