p_id,ycount,gcount,hfcount,fcount,sum
1,1,0,0,0,1
2,0,0,0,0,0
3,1,5,0,0,6
4,885,0,0,0,885
5,0,0,0,0,0
6,0,0,0,0,0
7,777,1488,0,0,2265
8,10,0,0,0,10
9,0,2,0,0,2
10,21,3,0,0,24
11,2,0,0,0,2
12,68,0,0,0,68
13,963,0,0,0,963
14,16,22,0,0,38
15,0,0,0,0,0
16,4,8,0,0,12
17,161,531,0,0,692
18,3,47,0,0,50
19,0,0,0,0,0
20,4,23,0,0,27
21,2,1,0,0,3
22,6,7,0,0,13
23,0,0,0,0,0
24,486,48,0,0,534
25,216,448,0,0,664
26,2,4,0,0,6
27,0,0,0,0,0
28,14,21,0,0,35
29,1,4,0,0,5
30,0,0,0,0,0
31,3,6,0,0,9
32,1,9,0,0,10
33,176,270,0,0,446
34,1,8,0,0,9
35,6,30,0,0,36
36,249,426,0,0,675
37,287,423,0,0,710
38,0,0,0,0,0
39,4,21,0,0,25
40,129,190,0,0,319
41,765,1232,0,0,1997
42,401,1043,0,0,1444
43,1286,68,0,0,1354
44,0,0,0,0,0
45,409,0,0,0,409
46,1,1,0,0,2
47,2,35,0,0,37
48,6207,0,0,0,6207
49,163,521,0,0,684
50,2778,0,0,0,2778
51,2,6,0,0,8
52,87,102,0,0,189
53,1,2,0,0,3
54,8,16,0,0,24
55,1,53,0,0,54
56,17,61,0,0,78
57,0,0,0,0,0
58,0,0,0,0,0
59,0,1,0,0,1
60,1,15,0,0,16
61,138,623,0,0,761
62,23,87,0,0,110
63,1,6,0,0,7
64,0,0,0,0,0
65,247,200,0,0,447
66,78,173,0,0,251
67,1,3,0,0,4
68,4881,0,0,0,4881
69,9,98,0,0,107
70,47,50,0,0,97
71,5,19,0,0,24
72,2,24,0,0,26
73,0,1,0,0,1
74,735,914,0,0,1649
75,979,578,0,0,1557
76,7,41,0,0,48
77,4,14,0,0,18
78,2,29,0,0,31
79,9245,0,0,0,9245
80,486,795,0,0,1281
81,1,6,0,0,7
82,173,1067,0,0,1240
83,78,200,0,0,278
84,0,0,0,0,0
85,8,77,0,0,85
86,0,1,0,0,1
87,1022,0,0,0,1022
88,436,0,0,0,436
89,42,109,0,0,151
90,3190,0,0,0,3190
91,4,21,0,0,25
92,8,203,0,0,211
93,11,33,0,0,44
94,0,22,0,0,22
95,58,540,0,0,598
96,1,1,0,0,2
97,240,480,0,0,720
98,0,3,0,0,3
99,0,0,0,0,0
100,2648,0,0,0,2648
101,0,0,0,0,0
102,6,7,0,0,13
103,0,0,0,0,0
104,0,0,0,0,0
105,0,0,0,0,0
106,52,223,0,0,275
107,4045,0,0,0,4045
108,2,0,0,0,2
109,0,0,0,0,0
110,0,0,0,0,0
111,1,3,0,0,4
112,248,744,0,0,992
113,2444,0,0,0,2444
114,3541,0,0,0,3541
115,0,0,0,0,0
116,249,405,0,0,654
117,2,3,0,0,5
118,0,0,0,0,0
119,5,48,0,0,53
120,1,5,0,0,6
121,2,3,0,0,5
122,0,2,0,0,2
123,2,3,0,0,5
124,2,1,0,0,3
125,817,0,0,0,817
126,2,26,0,0,28
127,34,144,0,0,178
128,3,2,0,0,5
129,250,1045,0,0,1295
130,18,237,0,0,255
131,3,5,0,0,8
132,2674,4,0,0,2678
133,20,14,0,0,34
134,14,109,0,0,123
135,5,9,0,0,14
136,6,30,0,0,36
137,2072,0,0,0,2072
138,2119,3,0,0,2122
139,1,0,0,0,1
140,1642,0,0,0,1642
141,2910,0,0,0,2910
142,2979,1,0,0,2980
143,1298,0,0,0,1298
144,2236,0,0,0,2236
145,263,396,0,0,659
146,259,159,0,0,418
147,1,22,0,0,23
148,5927,0,0,0,5927
149,3,4,0,0,7
150,2,15,0,0,17
151,1126,0,0,0,1126
152,190,155,0,0,345
153,4,9,0,0,13
154,3,0,0,0,3
155,1,3,0,0,4
156,0,6,0,0,6
157,18,28,0,0,46
158,3920,0,0,0,3920
159,30,128,0,0,158
160,4,6,0,0,10
161,3394,0,0,0,3394
162,3077,0,0,0,3077
163,3169,0,0,0,3169
164,4884,0,0,0,4884
165,8,4,0,0,12
166,662,494,0,0,1156
167,7,46,0,0,53
168,50,130,0,0,180
169,5,44,0,0,49
170,4521,0,0,0,4521
171,2,6,0,0,8
172,0,0,0,0,0
173,15,235,0,0,250
174,4,33,0,0,37
175,0,0,0,0,0
176,0,0,0,0,0
177,8,68,0,0,76
178,3,1,0,0,4
179,202,187,0,0,389
180,4,5,0,0,9
181,371,719,0,0,1090
182,3,47,0,0,50
183,0,7,0,0,7
184,0,9,0,0,9
185,2,18,0,0,20
186,4323,0,0,0,4323
187,0,1,0,0,1
188,35,163,0,0,198
189,105,208,0,0,313
190,20,29,0,0,49
191,2,1,0,0,3
192,4,9,0,0,13
193,71,27,0,0,98
194,11,5,0,0,16
195,13,33,0,0,46
196,51,112,0,0,163
197,13,21,0,0,34
198,31,36,0,0,67
199,0,0,0,0,0
200,1,1,0,0,2
201,2,1,0,0,3
202,13,6,0,0,19
203,0,0,0,0,0
204,0,0,0,0,0
205,1,2,0,0,3
206,0,0,0,0,0
207,0,0,0,0,0
208,2,18,0,0,20
209,274,0,0,0,274
210,1,68,0,0,69
211,1331,0,0,0,1331
212,1,45,0,0,46
213,0,13,0,0,13
214,0,0,0,0,0
215,7,5,0,0,12
216,12,21,0,0,33
217,51,42,0,0,93
218,0,0,0,0,0
219,3,1,0,0,4
220,12,21,0,0,33
221,0,0,0,0,0
222,2,1,0,0,3
223,243,427,0,0,670
224,656,0,0,0,656
225,103,288,0,0,391
226,503,285,0,0,788
227,6,9,0,0,15
228,41,96,0,0,137
229,2593,0,0,0,2593
230,5440,0,0,0,5440
231,2524,0,0,0,2524
232,601,0,0,0,601
233,1799,0,0,0,1799
234,4121,0,0,0,4121
235,5,37,0,0,42
236,2433,27,0,0,2460
237,2332,0,0,0,2332
238,2570,0,0,0,2570
239,2884,0,0,0,2884
240,0,1,0,0,1
241,3,37,0,0,40
242,4,32,0,0,36
243,62,199,0,0,261
244,202,376,0,0,578
245,0,0,0,0,0
246,2718,0,0,0,2718
247,23,143,0,0,166
248,2,19,0,0,21
249,4565,0,0,0,4565
250,5,32,0,0,37
251,0,0,0,0,0
252,0,0,0,0,0
253,0,7,0,0,7
254,3,18,0,0,21
255,760,2301,0,0,3061
256,711,1205,0,0,1916
257,9,38,0,0,47
258,5,15,0,0,20
259,8,1,0,0,9
260,264,648,0,0,912
261,819,0,0,0,819
262,1435,1,0,0,1436
263,2494,9,0,0,2503
